 #####
##   #
#@$ .#
##   #
 #####
;
 ##### #####
##   # #   ##
#@$ *# #    #
##   # #* .##
 ##### #####
;
 ########
##      #
#   .   #
#   $   #
# .$@$. #
####$   #
   #.   #
   #   ##
   ##### 