 #####
##   #
#@$ .#
##   #
 #####
;
  #### #####
 ##  # #   ##
##   # #    #
#@$ *# #* .##
##   # # ###
 ##### ###
;
 ########
##      #
#   .   #
#   $   #
# .$@$. #
####$   #
   #.   #
   #   ##
   ##### 
;
#####    ####
#   ##  ##  #
#    # ##   #
#*  ## #@$ *#
#.###  ##   #
###     #####
;
###########
#.  *#    #
# @  # *$ #
#  $ #  . #
#    #    #
###########
;
#############
#      .    #
# $ .    *$ #
#           #
#########   #
#    # .# $ #
#    #$ #   #
#    # *#   #
#. @    #   #
#############
;
#####
#   #####
# $ $ $ #
### # # #
  # #   #
 ## ### ##
 # .....@#
 # $ $   #
 # ###  ##
 #      #
 ########