 #####
##   #
#@$ .#
##   #
 #####
;
  #### #####
 ##  # #   ##
##   # #    #
#@$ *# #* .##
##   # # ###
 ##### ###
;
 ########
##      #
#   .   #
#   $   #
# .$@$. #
####$   #
   #.   #
   #   ##
   ##### 